frame,tp,fp,fn,gt_count,det_count,avg_conf,inference_ms
1,10,5,5,15,15,0.60523615082105,503.7105190567672
2,11,4,5,16,15,0.6169313251972198,12.462112121284008
3,11,4,5,16,15,0.6089136560757955,12.972073629498482
4,11,3,5,16,14,0.6247683933803013,8.950833231210709
5,11,4,5,16,15,0.6144818782806396,12.71968986839056
6,11,4,5,16,15,0.5957137962182363,13.217684347182512
7,11,4,5,16,15,0.590743358929952,13.995750807225704
8,10,4,6,16,14,0.6075405861650195,11.86624402180314
9,11,3,6,17,14,0.6039556775774274,11.859213933348656
10,12,4,5,17,16,0.5686429031193256,11.02467067539692
11,11,3,6,17,14,0.6329007191317422,9.668040089309216
12,11,4,6,17,15,0.6081451555093129,16.05111686512828
13,11,4,5,16,15,0.6029217799504598,10.500898119062185
14,11,4,5,16,15,0.5907242755095164,16.72375900670886
15,9,7,7,16,16,0.5582196991890669,9.884451050311327
16,9,4,7,16,13,0.6284508773913751,10.800652205944061
17,9,4,7,16,13,0.6238487821358901,10.824935045093298
18,8,5,8,16,13,0.5899062294226426,9.121020324528217
19,8,3,8,16,11,0.6409514925696633,13.287066016346216
20,7,5,8,15,12,0.5922596429785093,14.419550076127052
21,9,3,6,15,12,0.5883939762910207,10.225951205939054
22,11,3,4,15,14,0.5773116499185562,9.663789998739958
23,10,5,5,15,15,0.5480539262294769,8.974152151495218
24,10,4,6,16,14,0.5733770110777446,15.850178897380829
25,10,4,6,16,14,0.584659782903535,11.898851953446865
26,9,3,6,15,12,0.6346513703465462,10.149220936000347
27,10,2,5,15,12,0.5538116519649824,10.03734115511179
28,10,4,5,15,14,0.5579457219157901,12.813065201044083
29,9,3,6,15,12,0.5982243393858274,14.400236308574677
30,9,5,7,16,14,0.5759037456342152,9.316720068454742
31,9,6,7,16,15,0.5455832203229268,10.598897002637386
32,10,4,7,17,14,0.6012551550354276,10.861868038773537
33,10,4,7,17,14,0.5966671513659614,10.686768218874931
34,11,4,6,17,15,0.5480150580406189,9.800674859434366
35,11,5,6,17,16,0.5488435756415129,9.228179231286049
36,10,3,6,16,13,0.6057497079555805,11.41641614958644
37,10,3,6,16,13,0.612836860693418,11.606846936047077
38,9,5,7,16,14,0.5927025569336755,8.774013724178076
39,9,6,7,16,15,0.5659227808316548,11.74705196171999
40,10,4,5,15,14,0.6178887635469437,13.306735083460808
41,11,5,4,15,16,0.5859325286000967,11.61007396876812
42,11,6,4,15,17,0.5909427194034352,10.190437082201242
43,11,3,4,15,14,0.6019070276192257,13.316740281879902
44,10,3,5,15,13,0.598353617466413,13.238993939012289
45,10,4,5,15,14,0.5943751186132431,9.007757063955069
46,11,2,4,15,13,0.6050158257667835,10.385203640908003
47,9,5,6,15,14,0.6167132364852088,11.070912703871727
48,10,5,5,15,15,0.5516103486220042,12.050554621964693
49,9,5,6,15,14,0.5502524439777646,10.998758021742105
50,8,5,7,15,13,0.5677501077835376,11.755232233554125
51,7,7,8,15,14,0.5657453536987305,13.218892272561789
52,10,5,5,15,15,0.5709307412306468,12.279886286705732
53,10,7,5,15,17,0.5225566099671757,10.349498130381107
54,10,5,5,15,15,0.5334495027860006,9.766001719981432
55,9,7,6,15,16,0.5333162378519773,9.332031011581421
56,9,6,6,15,15,0.5590546528498331,11.215652339160442
57,8,7,6,14,15,0.5611526191234588,11.059421114623547
58,9,5,6,15,14,0.5469682131494794,15.052105765789747
59,9,6,6,15,15,0.523064394791921,10.843044146895409
60,8,8,6,14,16,0.5282074920833111,9.143686853349209
61,9,6,5,14,15,0.5304966747760773,12.491772882640362
62,8,6,5,13,14,0.5425821478877749,11.958884075284004
63,8,6,5,13,14,0.5068012369530541,9.130865335464478
64,8,2,5,13,10,0.5956434488296509,11.68006518855691
65,8,6,6,14,14,0.5185495849166598,9.866793174296618
66,9,6,6,15,15,0.49234052101771036,10.58820029720664
67,9,6,6,15,15,0.5099128862222035,9.998693130910397
68,9,3,6,15,12,0.532257467508316,9.013271424919367
69,9,3,6,15,12,0.5362875213225683,12.648864649236202
70,9,4,6,15,13,0.5040155626260318,14.375031925737858
71,11,5,4,15,16,0.4588310159742832,10.459464974701405
72,10,3,5,15,13,0.5440738751338079,10.052146390080452
73,9,4,6,15,13,0.566600345648252,12.326623778790236
74,11,3,4,15,14,0.5348213527883802,11.341826058924198
75,10,6,5,15,16,0.49000705406069756,9.700199123471975
76,9,4,6,15,13,0.545075155221499,10.292183142155409
77,10,4,5,15,14,0.510489895939827,11.113350745290518
78,9,2,7,16,11,0.5472262312065471,11.919857934117317
79,10,5,6,16,15,0.48391404549280803,10.329884942620993
80,10,5,6,16,15,0.48725734154383343,10.942509863525629
81,10,4,5,15,14,0.505615268434797,11.161587201058865
82,10,2,4,14,12,0.5727870166301727,13.251260854303837
83,10,2,4,14,12,0.569523885846138,9.593725204467773
84,9,2,5,14,11,0.58409998904575,12.71883212029934
85,9,2,5,14,11,0.6001759686253287,12.548217084258795
86,9,3,5,14,12,0.5622479567925135,10.506168007850647
87,8,4,6,14,12,0.5523172194759051,11.31967268884182
88,7,4,7,14,11,0.5813475115732714,13.684959150850773
89,9,4,5,14,13,0.5570905942183274,14.569021295756102
90,9,5,5,14,14,0.5308788418769836,9.409328922629356
91,10,5,6,16,15,0.548854664961497,12.31557922437787
92,11,4,5,16,15,0.5379612624645234,11.464452836662531
93,10,5,5,15,15,0.5353516856829326,16.515549272298813
94,9,5,5,14,14,0.559058598109654,10.167247150093317
95,7,3,7,14,10,0.6519908875226974,9.042407851666212
96,8,5,6,14,13,0.5928361782660851,11.997421272099018
97,8,3,6,14,11,0.6294647726145658,12.818526942282915
98,8,5,5,13,13,0.5621980864268082,15.318972058594227
99,9,4,4,13,13,0.593625579889004,12.93579488992691
100,9,5,4,13,14,0.5738214807850974,9.939528070390224
101,9,5,5,14,14,0.5706937313079834,11.45772635936737
102,8,6,6,14,14,0.5824802219867706,9.224425069987774
103,9,5,4,13,14,0.5817085674830845,17.764910124242306
104,9,7,5,14,16,0.5744907800108194,11.833807919174433
105,10,5,3,13,15,0.5601719995339711,11.759317014366388
106,9,5,4,13,14,0.5566473369087491,9.757780004292727
107,10,6,3,13,16,0.5067833848297596,9.567268192768097
108,9,4,4,13,13,0.5744410569851215,10.843806900084019
109,8,6,5,13,14,0.5653611166136605,9.90484980866313
110,9,4,4,13,13,0.5668422144192916,12.478682212531567
111,9,4,2,11,13,0.5712776780128479,12.702228967100382
112,8,4,3,11,12,0.5448080947001775,10.059127118438482
113,11,3,0,11,14,0.5140183312552316,12.077493593096733
114,9,3,2,11,12,0.5904523109396299,9.509538300335407
115,10,2,2,12,12,0.6122441962361336,12.398454826325178
116,11,3,1,12,14,0.5287851286785943,10.286484844982624
117,10,3,2,12,13,0.5310918184427115,9.229314979165792
118,11,5,1,12,16,0.5005431417375803,10.241303127259016
119,12,4,0,12,16,0.4978554714471102,9.108380880206823
120,8,4,4,12,12,0.575721800327301,9.62423300370574
121,11,4,2,13,15,0.5113356570402782,11.05068577453494
122,10,5,2,12,15,0.487852152188619,9.79263475164771
123,11,6,1,12,17,0.49147462844848633,11.936970055103302
124,11,5,1,12,16,0.4922477416694164,13.242925982922316
125,11,5,1,12,16,0.4770674388855696,11.674574110656977
126,10,6,2,12,16,0.4771695025265217,11.367392260581255
127,10,4,2,12,14,0.5110812932252884,9.122988674789667
128,10,3,3,13,13,0.546136335684703,12.645692098885775
129,10,3,3,13,13,0.5537699071260599,11.583908926695585
130,10,2,3,13,12,0.5512253269553185,9.606949053704739
131,11,2,3,14,13,0.5428713812277868,10.758797638118267
132,11,2,3,14,13,0.5624772722904499,9.987871162593365
133,11,4,3,14,15,0.5299983421961466,12.158962897956371
134,11,5,4,15,16,0.5161611344665289,11.961403302848339
135,12,2,4,16,14,0.5360580171857562,9.837911929935217
136,12,0,5,17,12,0.5703460425138474,15.660088043659925
137,11,1,6,17,12,0.5573100075125694,11.045437771826982
138,10,2,7,17,12,0.5669248675306638,12.509980704635382
139,10,5,7,17,15,0.4978832960128784,12.949103023856878
140,10,2,7,17,12,0.5671990265448889,13.80856428295374
141,10,2,7,17,12,0.606696143746376,14.34034202247858
142,9,2,8,17,11,0.6102832826701078,11.211717035621405
143,10,5,7,17,15,0.523475581407547,10.342082008719444
144,9,3,8,17,12,0.6089924151698748,8.940209168940783
145,9,3,7,16,12,0.6156609803438187,10.970904026180506
146,11,2,5,16,13,0.5703500830210172,12.475776020437479
147,11,2,5,16,13,0.5916198675449078,9.843129198998213
148,12,2,4,16,14,0.5755295732191631,11.806199792772532
149,12,1,3,15,13,0.6294472836531125,11.479710694402456
150,12,1,3,15,13,0.5794981053242316,10.968343820422888
151,12,1,3,15,13,0.6143117661659534,10.35778596997261
152,12,2,3,15,14,0.5745384267398289,14.1668189316988
153,11,3,4,15,14,0.5707879619938987,11.788440868258476
154,11,3,5,16,14,0.575891090290887,12.689363677054644
155,12,4,3,15,16,0.5368245113641024,10.311190970242023
156,10,3,5,15,13,0.5886998978944925,9.05901612713933
157,10,2,5,15,12,0.5843556846181551,9.929454885423183
158,11,3,4,15,14,0.554497995546886,9.977651294320822
159,11,2,4,15,13,0.5743270699794476,10.549037251621485
160,12,2,3,15,14,0.552221845303263,12.141949031502008
161,12,1,2,14,13,0.5817859608393449,14.703253284096718
162,11,1,3,14,12,0.643361434340477,10.527271777391434
163,13,1,1,14,14,0.583490463239806,9.776898194104433
164,10,3,3,13,13,0.606837109877513,9.453231003135443
165,11,2,2,13,13,0.5953886738190284,10.977271012961864
166,12,2,1,13,14,0.5619345137051174,10.80847391858697
167,12,2,1,13,14,0.5467266312667302,11.566015891730785
168,11,4,2,13,15,0.5559155702590942,10.14371495693922
169,11,3,2,13,14,0.5699472874403,9.33619774878025
170,9,4,4,13,13,0.5735767758809603,11.804528068751097
171,9,5,4,13,14,0.5692688205412456,11.432116851210594
172,10,5,3,13,15,0.5430511514345805,11.216960847377777
173,10,4,2,12,14,0.5659535718815667,9.870240930467844
174,10,3,2,12,13,0.5990476677050958,8.937624283134937
175,9,3,3,12,12,0.6007097537318865,11.14719407632947
176,10,2,3,13,12,0.6075974752505621,10.401146952062845
177,9,4,4,13,13,0.5591584948393015,9.467655792832375
178,9,2,3,12,11,0.6090043132955377,12.692220974713564
179,9,2,3,12,11,0.6148211549628865,13.478981330990791
180,9,2,3,12,11,0.61866633458571,12.199271004647017
181,9,2,3,12,11,0.6219626583836295,11.00365910679102
182,9,2,2,11,11,0.6267197077924554,10.007595643401146
183,11,2,2,13,13,0.5814058459722079,13.514598831534386
184,11,1,3,14,12,0.5890621493260065,14.498315751552582
185,10,2,4,14,12,0.5945711260040601,10.4364980943501
186,10,2,4,14,12,0.6224517300724983,10.367012117058039
187,11,2,4,15,13,0.5846707958441514,9.665036108344793
188,8,1,8,16,9,0.7184511191315122,11.479952838271856
189,11,1,5,16,12,0.6028279413779577,14.41597007215023
190,11,1,5,16,12,0.6142657175660133,12.057230807840824
191,12,1,4,16,13,0.6025595802527207,10.592400096356869
192,12,2,4,16,14,0.571520175252642,9.53918881714344
193,12,2,4,16,14,0.5931730163948876,13.368126004934311
194,12,1,4,16,13,0.6223719876546127,13.699810951948166
195,12,2,4,16,14,0.596339721764837,10.139178019016981
196,12,1,3,15,13,0.6059947426502521,9.721358772367239
197,12,1,3,15,13,0.6023766719377958,9.284963831305504
198,10,2,4,14,12,0.65265520910422,10.492685250937939
199,11,2,3,14,13,0.6104890772929559,9.082962293177843
200,10,2,4,14,12,0.6307137335340182,10.044410359114408
201,10,4,4,14,14,0.6025750083582742,12.172246351838112
202,11,3,3,14,14,0.5734394852604184,10.46961173415184
203,11,1,3,14,12,0.6130996346473694,11.726832017302513
204,11,1,4,15,12,0.6284365902344385,12.244842946529388
205,10,1,5,15,11,0.6263621747493744,10.175166185945272
206,11,1,4,15,12,0.6127706716458002,11.424004565924406
207,10,2,5,15,12,0.5852310433983803,9.454088751226664
208,9,2,5,14,11,0.6198078935796564,10.88907616212964
209,8,3,5,13,11,0.6294356232339685,9.774502832442522
210,8,2,5,13,10,0.6537568539381027,9.31056309491396
211,8,5,5,13,13,0.5605126390090356,10.68359101191163
212,8,4,5,13,12,0.6133917272090912,11.289818212389946
213,8,3,5,13,11,0.6655081320892681,10.290252976119518
214,8,3,6,14,11,0.6773057796738364,10.494090151041746
215,8,4,6,14,12,0.6317175899942716,9.589636232703924
216,8,3,6,14,11,0.6814662651582197,12.48716888949275
217,9,3,5,14,12,0.6462573856115341,15.252611134201288
218,10,3,4,14,13,0.588102604334171,11.341300327330828
219,10,2,4,14,12,0.61220699797074,10.34415140748024
220,10,2,4,14,12,0.6129811132947603,9.550249204039574
221,11,1,5,16,12,0.6255343556404114,10.898018721491098
222,11,2,6,17,13,0.5869768170210031,13.756829779595137
223,11,1,6,17,12,0.6223878736297289,13.187428005039692
224,11,1,6,17,12,0.640693706770738,10.399701073765755
225,10,2,7,17,12,0.6266539717713991,9.360111318528652
226,9,1,9,18,10,0.6884476125240326,13.390015810728073
227,9,1,9,18,10,0.6676823258399963,14.362836256623268
228,7,3,9,16,10,0.6565538614988327,10.40230318903923
229,8,3,8,16,11,0.6147982586513866,10.377620346844196
230,6,4,8,14,10,0.6557560563087463,9.543080814182758
231,6,7,8,14,13,0.5848050851088303,14.58146795630455
232,7,9,7,14,16,0.5082443840801716,13.208843301981688
233,8,7,7,15,15,0.5256965140501658,10.318547021597624
234,8,6,7,15,14,0.5567223812852587,10.537547990679741
235,8,5,7,15,13,0.589699754348168,11.907189153134823
236,8,6,7,15,14,0.5614943632057735,10.415912140160799
237,7,4,9,16,11,0.6394985751672224,10.831417050212622
238,7,3,10,17,10,0.6672909945249558,10.197164956480265
239,7,2,10,17,9,0.7094474401738908,10.315677616745234
240,8,3,10,18,11,0.6233157840642062,9.82854189351201
241,9,4,10,19,13,0.5663245228620676,11.352248955518007
242,10,2,7,17,12,0.591187392671903,12.584134936332703
243,10,5,6,16,15,0.5522792319456736,9.966789279133081
244,8,4,9,17,12,0.5845122287670771,11.97685906663537
245,9,5,9,18,14,0.5523178960595813,10.558238718658686
246,9,4,9,18,13,0.6062695475725027,10.435846168547869
247,9,4,9,18,13,0.5965095208241389,9.14638489484787
248,8,4,10,18,12,0.573273204267025,10.130412876605988
249,7,4,11,18,11,0.5951275364919142,10.371883865445852
250,8,5,11,19,13,0.5957452952861786,9.933452121913433
251,9,5,10,19,14,0.6091204179184777,10.885706171393394
252,8,6,9,17,14,0.5696356126240322,10.36049285903573
253,8,3,10,18,11,0.6460388655012305,9.090642910450697
254,9,3,8,17,12,0.6006283337871233,10.8566265553236
255,10,4,8,18,14,0.5510105043649673,10.4810013435781
256,9,3,9,18,12,0.6046513840556145,9.974706918001175
257,10,3,8,18,13,0.6020010113716125,10.544324293732643
258,10,3,8,18,13,0.5880254209041595,9.257038123905659
259,10,3,9,19,13,0.5845441290965447,11.100919917225838
260,8,4,11,19,12,0.5891302252809206,12.015376705676317
261,9,3,9,18,12,0.5853965828816096,10.764190927147865
262,9,2,9,18,11,0.6018049202182076,10.588725097477436
263,11,1,8,19,12,0.5706641698877016,10.201365686953068
264,11,2,8,19,13,0.5433668310825641,15.84378071129322
265,11,3,8,19,14,0.5435028097459248,12.611707206815481
266,9,1,11,20,10,0.6495372205972672,11.147629003971815
267,9,2,11,20,11,0.6312163011594252,12.005892116576433
268,10,3,9,19,13,0.5630331452076252,10.419537778943777
269,10,1,10,20,11,0.6359056613662026,12.08274532109499
270,9,3,10,19,12,0.5988657797376314,9.822261985391378
271,8,2,11,19,10,0.6679653823375702,10.976058896631002
272,10,2,10,20,12,0.6070387611786524,9.467897936701775
273,9,2,10,19,11,0.6403043649413369,10.105420835316181
274,9,1,10,19,10,0.6729213058948517,12.831998988986015
275,8,2,12,20,10,0.6573393642902374,11.737741995602846
276,8,4,12,20,12,0.6155379563570023,10.823969263583422
277,8,2,12,20,10,0.6402226865291596,10.381306987255812
278,9,2,11,20,11,0.6387079060077667,12.056777719408274
279,8,3,11,19,11,0.6287878291173414,12.102741282433271
280,8,4,10,18,12,0.5868432397643725,9.393891785293818
281,8,3,10,18,11,0.633536392992193,10.898951906710863
282,8,4,9,17,12,0.5963998114069303,10.837269946932793
283,8,5,9,17,13,0.5837562221747178,12.317894957959652
284,9,3,8,17,12,0.5798642014463743,10.518894996494055
285,8,2,9,17,10,0.6238578736782074,9.397407993674278
286,8,3,9,17,11,0.6059061668135903,10.054088197648525
287,8,3,9,17,11,0.6283740238709883,10.408275295048952
288,9,2,8,17,11,0.6149146096272902,9.341072756797075
289,8,3,9,17,11,0.6245453953742981,11.591217014938593
290,10,2,8,18,12,0.6075426638126373,10.92900475487113
291,9,3,10,19,12,0.582797646522522,11.48815592750907
292,9,3,9,18,12,0.5973906765381495,10.92977775260806
293,8,3,10,18,11,0.6199142689054663,10.41765883564949
294,9,3,9,18,12,0.619599737226963,11.202552821487188
295,9,4,9,18,13,0.5798409627034113,13.741081114858389
296,8,3,10,18,11,0.6357681859623302,11.709321290254593
297,8,4,9,17,12,0.6307390183210373,10.68361522629857
298,8,4,9,17,12,0.6621141483386358,9.979357942938805
299,8,5,9,17,13,0.63685797728025,10.119940154254436
300,9,3,9,18,12,0.6746605783700943,10.399262886494398
301,9,4,9,18,13,0.6719030371079078,10.652984026819468
302,9,3,9,18,12,0.7046930765112241,10.468715336173773
303,9,4,9,18,13,0.6734581062426934,9.413927793502808
304,10,2,9,19,12,0.6889008829991022,11.435264255851507
305,10,3,9,19,13,0.678154665690202,10.193574707955122
306,10,3,9,19,13,0.6963347173654116,12.609807774424553
307,10,2,9,19,12,0.7230379631121954,10.523400735110044
308,10,3,8,18,13,0.7179612081784469,9.32687520980835
309,10,3,9,19,13,0.7169953194948343,11.26022171229124
310,9,3,10,19,12,0.7263732726375262,11.715580243617296
311,10,4,8,18,14,0.6807620227336884,9.752694051712751
312,10,3,8,18,13,0.7173067973210261,10.171831585466862
313,10,3,8,18,13,0.7261804571518531,9.155874140560627
314,10,3,8,18,13,0.7283176710972419,12.961514759808779
315,10,4,7,17,14,0.6974452180521828,13.243052177131176
316,11,4,6,17,15,0.651908830801646,10.245086159557104
317,11,4,6,17,15,0.67621075908343,10.049948934465647
318,11,4,6,17,15,0.6550105273723602,9.954503271728754
319,11,3,6,17,14,0.6864252580063683,13.897662051022053
320,10,4,7,17,14,0.710781529545784,12.98808678984642
321,10,5,7,17,15,0.669282074769338,14.667884912341833
322,10,5,7,17,15,0.6552282869815826,11.72909326851368
323,10,4,6,16,14,0.6794038329805646,10.475107003003359
324,10,4,5,15,14,0.6720949986151287,10.305911302566528
325,10,4,5,15,14,0.6802519943032946,9.549605194479227
326,11,3,5,16,14,0.6374158731528691,10.49625501036644
327,10,6,6,16,16,0.6031150817871094,9.783715009689331
328,10,5,6,16,15,0.6146414677302042,12.463558930903673
329,9,6,7,16,15,0.6086718519528707,11.817649006843567
330,9,8,6,15,17,0.5399671985822565,10.748611763119698
331,9,6,7,16,15,0.5819304923216502,10.118221864104271
332,8,7,8,16,15,0.6141185661156973,9.83434310182929
333,8,8,8,16,16,0.5905892755836248,9.966612327843904
334,8,8,8,16,16,0.5541312023997307,11.842717416584492
335,8,5,9,17,13,0.6273484230041504,10.963554959744215
336,9,7,8,17,16,0.5641551669687033,10.055911727249622
337,7,9,7,14,16,0.5446575004607439,9.068961720913649
338,7,10,8,15,17,0.5456032419905943,10.381718166172504
339,6,10,8,14,16,0.5425789970904589,9.840528015047312
340,5,8,9,14,13,0.6026592392187852,10.920091066509485
341,5,7,9,14,12,0.6024492358167967,13.62335728481412
342,5,7,9,14,12,0.5734435518582662,11.858082376420498
343,5,5,10,15,10,0.6354795515537262,10.501207783818245
344,5,7,10,15,12,0.5760925536354383,9.761606808751822
345,5,7,10,15,12,0.5525679190953573,10.458341799676418
346,5,7,10,15,12,0.5500163063406944,11.516992002725601
347,5,8,10,15,13,0.5512537176792438,11.522613000124693
348,6,5,9,15,11,0.6032755347815427,14.494956936687231
349,5,6,10,15,11,0.6052337234670465,11.77213666960597
350,5,5,10,15,10,0.654566615819931,13.216656167060137
351,5,6,9,14,11,0.6306679275902835,11.543341912329197
352,5,6,9,14,11,0.632185778834603,10.044537018984556
353,5,6,10,15,11,0.6428787356073206,13.647635001689196
354,5,7,10,15,12,0.6153650358319283,14.792133122682571
355,6,7,8,14,13,0.6079876789679894,10.761207900941372
356,6,5,7,13,11,0.6737339415333488,10.18398767337203
357,6,5,6,12,11,0.6672854017127644,9.644888807088137
358,6,5,6,12,11,0.6694381535053253,13.181022834032774
359,6,5,6,12,11,0.662013517184691,14.670245815068483
360,5,4,6,11,9,0.7251616716384888,10.986313223838806
361,6,4,5,11,10,0.657767477631569,10.146014858037233
362,6,5,5,11,11,0.6370289705016396,9.404276963323355
363,6,5,5,11,11,0.6576364230025898,12.1685191988945
364,6,5,5,11,11,0.665603984485973,15.350840985774994
365,6,5,4,10,11,0.6528958651152524,11.25879306346178
366,6,5,4,10,11,0.6561629636721178,10.45682793483138
367,7,5,3,10,12,0.6331103816628456,10.05506468936801
368,7,6,3,10,13,0.6188562191449679,10.534066706895828
369,7,8,3,10,15,0.5697698016961416,10.389645118266344
370,6,8,3,9,14,0.6081739472491401,12.508866842836142
371,6,9,3,9,15,0.5762676477432251,10.957656893879175
372,6,9,3,9,15,0.5794582724571228,9.311472997069359
373,7,9,3,10,16,0.5452957581728697,10.119793936610222
374,6,9,4,10,15,0.6189132769902547,9.50313312932849
375,6,7,5,11,13,0.6269335792614863,9.822713676840067
376,6,7,5,11,13,0.6565112723754003,10.915950872004032
377,7,3,4,11,10,0.7331286400556565,9.938891977071762
378,8,4,2,10,12,0.6513819967706999,9.869118221104145
379,8,5,2,10,13,0.6192565606190608,10.651313699781895
380,8,4,2,10,12,0.6478153293331465,11.38765411451459
381,7,2,3,10,9,0.7380147907469008,10.745230130851269
382,8,4,4,12,12,0.6318938781817754,10.129027999937534
383,9,4,3,12,13,0.5879535835522872,9.681415744125843
384,8,4,3,11,12,0.6713587418198586,11.634932830929756
385,8,4,3,11,12,0.6597270965576172,10.767642874270678
386,8,4,3,11,12,0.682465116182963,11.35968416929245
387,8,5,3,11,13,0.6247234780054826,11.54361478984356
388,8,6,2,10,14,0.6047337395804269,9.584350977092981
389,8,6,1,9,14,0.6129918907369886,10.801146272569895
390,8,4,1,9,12,0.6452333976825079,10.139547288417816
391,8,6,2,10,14,0.5978416821786335,9.96002508327365
392,8,5,2,10,13,0.6094534580524151,10.075191967189312
393,7,5,4,11,12,0.6480938543876013,10.67058416083455
394,8,5,2,10,13,0.6304465050880725,9.981713257730007
395,8,6,2,10,14,0.6095118799379894,10.631818789988756
396,7,4,4,11,11,0.6980735957622528,9.360404219478369
397,7,4,4,11,11,0.712315255945379,10.8939572237432
398,7,3,5,12,10,0.7555452734231949,9.761319030076265
399,7,4,4,11,11,0.7022407732226632,10.15890995040536
400,7,3,3,10,10,0.7483355075120925,10.727331973612309
401,7,3,3,10,10,0.7510790824890137,10.897529777139425
402,7,3,3,10,10,0.7434653639793396,10.052514262497425
403,7,4,3,10,11,0.7165972102772106,10.71800384670496
404,7,5,2,9,12,0.6821774492661158,9.425397031009197
405,7,6,2,9,13,0.6336215551082904,10.122128762304783
406,7,4,2,9,11,0.7180338393558156,12.062275782227516
407,7,5,2,9,12,0.6682764862974485,12.132833246141672
408,7,5,2,9,12,0.6511097947756449,14.77052504196763
409,7,4,2,9,11,0.7087746994061903,10.81088837236166
410,7,5,2,9,12,0.66921133796374,11.963252909481525
411,7,5,2,9,12,0.674217070142428,10.360505431890488
412,7,5,2,9,12,0.6446120043595632,10.076108854264021
413,8,3,2,10,11,0.68721604347229,13.260196894407272
414,8,3,2,10,11,0.675161293961785,11.033162008970976
415,8,3,2,10,11,0.6779330562461506,9.940050076693296
416,7,5,2,9,12,0.6808941488464674,10.172871872782707
417,7,4,2,9,11,0.6858042939142748,10.08076872676611
418,7,5,2,9,12,0.6691061134139696,11.4250797778368
419,7,5,2,9,12,0.6620304932196935,12.043988797813654
420,7,5,2,9,12,0.6426593065261841,11.368881911039352
421,8,4,2,10,12,0.6451229875286421,10.092406999319792
422,8,4,2,10,12,0.645875779290994,9.790870826691389
423,8,5,2,10,13,0.6338876439974859,11.742127127945423
424,8,3,2,10,11,0.6770870550112291,12.762316036969423
425,8,2,2,10,10,0.7113665282726288,9.950666222721338
426,8,4,3,11,12,0.6364165395498276,10.82315482199192
427,8,5,2,10,13,0.6224211385616889,9.424563962966204
428,8,4,4,12,12,0.6842166806260744,11.102384887635708
429,8,4,4,12,12,0.7113579461971918,10.26926375925541
430,8,3,4,12,11,0.719792059876702,9.22436686232686
431,8,4,3,11,12,0.6445602228244146,14.793457929044962
432,9,6,2,11,15,0.6124705533186595,9.256611112505198
433,9,5,1,10,14,0.6147671214171818,10.003708768635988
434,7,9,3,10,16,0.6100662015378475,10.103997774422169
435,8,8,2,10,16,0.6151158679276705,12.446645647287369
436,6,9,2,8,15,0.6334514220555624,11.651996988803148
437,7,7,1,8,14,0.6321591692311423,12.308804783970118
438,6,5,3,9,11,0.6859904446385123,10.648582130670547
439,6,6,2,8,12,0.6547835096716881,11.37588918209076
440,6,4,2,8,10,0.6925355881452561,11.258661281317472
441,5,6,2,7,11,0.7433826110579751,10.232964996248484
442,7,4,0,7,11,0.6968861547383395,10.244243778288364
443,8,5,0,8,13,0.615069336616076,10.439620818942785
444,9,3,0,9,12,0.7045637418826421,10.755362920463085
445,9,3,2,11,12,0.6846564014752706,11.239415965974331
446,8,7,2,10,15,0.6360620240370433,10.64653741195798
447,8,8,2,10,16,0.6242558304220438,10.264345444738865
448,7,9,2,9,16,0.6371785774827003,9.54862218350172
449,8,5,2,10,13,0.6592027957622821,12.862768955528736
450,8,8,0,8,16,0.604640418663621,15.362082049250603
451,8,5,2,10,13,0.6667221188545227,11.65299816057086
452,7,5,3,10,12,0.7350544085105261,11.052340734750032
453,7,7,3,10,14,0.630213554416384,9.34065505862236
454,6,5,3,9,11,0.7502846609462391,11.098572984337807
455,8,6,2,10,14,0.636590280703136,9.346713311970234
456,8,6,1,9,14,0.6108076125383377,9.529929142445326
457,6,8,2,8,14,0.6186203914029258,18.006375059485435
458,5,7,3,8,12,0.6613976210355759,16.599655151367188
459,6,6,3,9,12,0.674740788837274,13.906965032219887
460,7,7,3,10,14,0.626880366887365,16.819826792925596
461,6,6,4,10,12,0.7227988714973131,14.362263027578592
462,7,6,3,10,13,0.6880544997178591,18.42712704092264
463,8,5,4,12,13,0.7118783822426429,16.16128394380212
464,8,5,4,12,13,0.68615355858436,17.801885027438402
465,8,5,4,12,13,0.7289108175497788,15.399844851344824
466,8,5,4,12,13,0.6958691133902624,16.600076109170914
467,7,5,5,12,12,0.7272815555334091,16.431808937340975
468,7,7,6,13,14,0.6574157838310514,16.020804177969694
469,9,6,5,14,15,0.6130348265171051,18.140003085136414
470,9,4,4,13,13,0.6775123087259439,15.018993988633156
471,9,5,5,14,14,0.6844726098435265,16.751335002481937
472,10,3,7,17,13,0.6941386965604929,15.679874923080206
473,10,3,7,17,13,0.6708825551546537,16.034663189202547
474,10,3,8,18,13,0.6977518200874329,17.44368812069297
475,11,3,7,18,14,0.67635421029159,14.22838680446148
476,11,5,6,17,16,0.6344613637775183,15.600470826029778
477,10,6,7,17,16,0.6374940276145935,15.231480356305838
478,10,5,7,17,15,0.6678269882996877,16.26008003950119
479,10,5,7,17,15,0.6501606682936351,17.758630216121674
480,9,4,10,19,13,0.731399091390463,14.650250785052776
481,10,5,10,20,15,0.6864250342051188,15.893263276666403
482,9,4,11,20,13,0.7204466003638047,15.847669914364815
483,10,6,10,20,16,0.6564457062631845,12.948667164891958
484,11,5,8,19,16,0.6627679113298655,15.77971177175641
485,11,5,9,20,16,0.6659091059118509,14.226051978766918
486,11,5,7,18,16,0.657973475754261,15.242284629493952
487,11,7,8,19,18,0.6179665293958452,15.665183309465647
488,9,6,9,18,15,0.6809646447499593,16.09129225835204
489,11,7,7,18,18,0.59733075565762,16.14996697753668
490,10,7,9,19,17,0.6024541381527396,15.342491213232279
491,10,6,9,19,16,0.5994987692683935,16.15247316658497
492,12,5,6,18,17,0.5816091544487897,15.009368769824505
493,12,5,7,19,17,0.5704547552501454,15.004491899162531
494,12,5,6,18,17,0.5721702663337483,17.202876042574644
495,11,3,7,18,14,0.6523832678794861,14.118584338575602
496,12,2,6,18,14,0.6304778563124793,17.921401653438807
497,12,2,5,17,14,0.6343693328755242,16.53806585818529
498,12,4,4,16,16,0.5915912799537182,15.203814022243023
499,12,3,4,16,15,0.6430347760518392,20.130357705056667
500,12,3,4,16,15,0.6310768942038218,11.93920336663723
501,11,4,5,16,15,0.6295868774255117,15.384129248559475
502,12,4,4,16,16,0.6128470525145531,15.703811310231686
503,12,4,4,16,16,0.6241847332566977,15.863141976296902
504,12,4,3,15,16,0.6105890832841396,16.88392972573638
505,12,5,3,15,17,0.6050659383044523,15.127175021916628
506,12,3,3,15,15,0.6444759249687195,16.913061030209064
507,13,4,4,17,17,0.6010154906441184,16.83301292359829
508,12,2,5,17,14,0.6932350780282702,14.545002020895481
509,13,4,4,17,17,0.6024046645444983,17.639266792684793
510,13,2,4,17,15,0.6489674091339112,14.649888966232538
511,14,2,3,17,16,0.6246543694287539,16.171217896044254
512,14,2,3,17,16,0.6467180289328098,15.311258379369974
513,14,3,3,17,17,0.6494311725392061,15.46742208302021
514,12,3,4,16,15,0.6939301550388336,16.681265085935593
515,13,3,3,16,16,0.6699960362166166,15.388373285531998
516,13,3,4,17,16,0.6722578015178442,15.548129100352526
517,12,4,5,17,16,0.6726606748998165,17.14118616655469
518,12,3,5,17,15,0.6999962151050567,14.443702064454556
519,13,4,4,17,17,0.6440931733916787,16.28659386187792
520,13,3,5,18,16,0.6442165952175856,15.088621992617846
521,12,3,5,17,15,0.671154663960139,14.955785125494003
522,12,3,5,17,15,0.6523684163888296,16.556096728891134
523,13,3,4,17,16,0.6530508622527122,15.147204045206308
524,13,3,5,18,16,0.6602354254573584,15.671844128519297
525,13,3,5,18,16,0.6434211935847998,13.825132045894861
526,13,2,4,17,15,0.66247864762942,16.18334511294961
527,13,2,4,17,15,0.6801372547944387,14.866756275296211
528,13,1,4,17,14,0.7215070405176708,13.473671860992908
529,13,2,4,17,15,0.6916221857070923,17.83427270129323
530,13,2,4,17,15,0.6749775767326355,14.866818208247423
531,13,1,4,17,14,0.7160685956478119,15.403487253934145
532,12,2,5,17,14,0.7173257214682442,16.008558217436075
533,13,2,5,18,15,0.6633622030417125,14.814976137131453
534,13,1,5,18,14,0.7087947236640113,18.103040289133787
535,13,2,5,18,15,0.6825095057487488,12.995481956750154
536,12,2,7,19,14,0.716786442058427,15.483330935239792
537,12,2,5,17,14,0.7082617580890656,14.81579290702939
538,12,2,5,17,14,0.717147729226521,14.686186332255602
539,13,1,6,19,14,0.7101399004459381,18.369225785136223
540,13,1,5,18,14,0.6929769366979599,14.797268901020288
541,14,1,4,18,15,0.6627176761627197,14.038323890417814
542,13,1,6,19,14,0.7017702289990017,14.332650694996119
543,12,2,7,19,14,0.7061089596578053,14.527441002428532
544,12,2,7,19,14,0.6942700083766665,14.271238818764687
545,12,2,7,19,14,0.6816928855010441,13.697721064090729
546,13,2,7,20,15,0.655759592851003,13.77198426052928
547,12,3,8,20,15,0.6521478831768036,14.571639243513346
548,13,2,7,20,15,0.6439267675081889,14.785625040531158
549,14,2,7,21,16,0.6018570642918348,17.208398785442114
550,13,4,6,19,17,0.5699029652511373,14.023201074451208
551,12,4,6,18,16,0.5842231158167124,13.495593331754208
552,13,2,5,18,15,0.5981463690598806,13.28899897634983
553,13,2,5,18,15,0.6003336111704508,10.581264272332191
554,12,1,6,18,13,0.6514782630480253,12.832961045205593
555,11,1,6,17,12,0.6676574548085531,10.49965899437666
556,11,1,7,18,12,0.6598561579982439,13.787331990897655
557,12,1,6,18,13,0.6485864588847527,11.148487217724323
558,12,1,7,19,13,0.6577705374130836,12.054990977048874
559,12,1,7,19,13,0.6752985555392045,12.469061184674501
560,12,1,7,19,13,0.6589772884662335,11.011358816176653
561,12,0,7,19,12,0.7052824248870214,12.97228829935193
562,12,1,7,19,13,0.6563143913562481,10.888013057410717
563,12,2,7,19,14,0.6286173697028842,12.8327002748847
564,12,3,6,18,15,0.5974112649758657,11.488855816423893
565,11,2,7,18,13,0.6466189737503345,11.956207919865847
566,12,3,6,18,15,0.5802415152390797,12.119959108531475
567,12,3,5,17,15,0.5793660521507263,10.871094651520252
568,12,3,5,17,15,0.607852186759313,12.919326778501272
569,12,3,5,17,15,0.6231375972429911,10.365878697484732
570,11,3,5,16,14,0.6403985576970237,13.238959014415741
571,11,5,6,17,16,0.6171705182641745,11.669991072267294
572,11,3,6,17,14,0.6713421898228782,11.123380158096552
573,11,2,6,17,13,0.6724463517849262,12.253021355718374
574,11,3,6,17,14,0.631844488637788,11.547194793820381
575,12,4,4,16,16,0.5664160046726465,12.526873964816332
576,12,2,4,16,14,0.6134847785745349,10.729257017374039
577,12,5,4,16,17,0.5638081904719857,12.446084059774876
578,12,5,4,16,17,0.5829365235917708,11.764614842832088
579,12,4,3,15,16,0.6227522548288107,12.295133899897337
580,11,7,4,15,18,0.571970479355918,10.91012405231595
581,11,2,4,15,13,0.6728681142513568,11.80160092189908
582,12,1,4,16,13,0.6897530670349414,12.62168399989605
583,12,2,4,16,14,0.6450848536831992,10.767107829451561
584,12,3,4,16,15,0.626248296101888,13.15397722646594
585,12,2,4,16,14,0.6225947737693787,10.941026732325554
586,12,2,5,17,14,0.5993377630199704,13.377780094742775
587,11,4,4,15,15,0.6093407015005747,13.951058965176344
588,11,4,4,15,15,0.6142295201619467,12.19783490523696
589,11,5,4,15,16,0.6117793414741755,12.163310777395964
590,10,4,5,15,14,0.6508584107671466,11.03671919554472
591,11,6,4,15,17,0.5759524159571704,12.943536974489689
592,11,4,5,16,15,0.5968258639176687,10.299216024577618
593,11,4,5,16,15,0.5936154027779897,12.70846463739872
594,12,4,3,15,16,0.5561381224542856,11.019105091691017
595,11,4,4,15,15,0.5686488608519237,11.879848781973124
596,11,4,4,15,15,0.5936955531438192,12.392120901495218
597,11,4,5,16,15,0.5907664100329081,10.841127019375563
598,12,5,4,16,17,0.5355626747888678,12.866321951150894
599,12,4,4,16,16,0.5658361371606588,10.638369712978601
600,11,2,7,18,13,0.6131137884580172,12.70967721939087
