frame,n_gt,n_det,tp,fp,fn,precision,recall,timing
1,23,23,9,14,14,0.391304347826087,0.391304347826087,"{'preprocess': 0.0814049243927002, 'inference': 0.19160819053649902, 'postprocess': 0.04807305335998535, 'total': 0.32108616828918457}"
2,23,20,11,9,12,0.55,0.4782608695652174,"{'preprocess': 0.07010912895202637, 'inference': 0.008438587188720703, 'postprocess': 0.03862166404724121, 'total': 0.11716938018798828}"
3,23,21,10,11,13,0.47619047619047616,0.43478260869565216,"{'preprocess': 0.06104397773742676, 'inference': 0.005929708480834961, 'postprocess': 0.04099297523498535, 'total': 0.10796666145324707}"
4,23,22,11,11,12,0.5,0.4782608695652174,"{'preprocess': 0.0553898811340332, 'inference': 0.006094455718994141, 'postprocess': 0.04083395004272461, 'total': 0.10231828689575195}"
5,23,25,11,14,12,0.44,0.4782608695652174,"{'preprocess': 0.055803775787353516, 'inference': 0.006064176559448242, 'postprocess': 0.04079914093017578, 'total': 0.10266709327697754}"
6,23,28,11,17,12,0.39285714285714285,0.4782608695652174,"{'preprocess': 0.05543994903564453, 'inference': 0.006013393402099609, 'postprocess': 0.03981757164001465, 'total': 0.10127091407775879}"
7,23,26,11,15,12,0.4230769230769231,0.4782608695652174,"{'preprocess': 0.05600094795227051, 'inference': 0.006059885025024414, 'postprocess': 0.039524078369140625, 'total': 0.10158491134643555}"
8,23,22,10,12,13,0.45454545454545453,0.43478260869565216,"{'preprocess': 0.05515742301940918, 'inference': 0.006058216094970703, 'postprocess': 0.039499521255493164, 'total': 0.10071516036987305}"
9,23,25,10,15,13,0.4,0.43478260869565216,"{'preprocess': 0.05538606643676758, 'inference': 0.006093502044677734, 'postprocess': 0.03878903388977051, 'total': 0.10026860237121582}"
10,23,28,10,18,13,0.35714285714285715,0.43478260869565216,"{'preprocess': 0.055199623107910156, 'inference': 0.005850076675415039, 'postprocess': 0.03846478462219238, 'total': 0.09951448440551758}"
11,23,21,9,12,14,0.42857142857142855,0.391304347826087,"{'preprocess': 0.05533719062805176, 'inference': 0.0057756900787353516, 'postprocess': 0.038619279861450195, 'total': 0.0997321605682373}"
12,23,23,9,14,14,0.391304347826087,0.391304347826087,"{'preprocess': 0.055284738540649414, 'inference': 0.005978822708129883, 'postprocess': 0.038748979568481445, 'total': 0.10001254081726074}"
13,23,22,9,13,14,0.4090909090909091,0.391304347826087,"{'preprocess': 0.05557584762573242, 'inference': 0.0061054229736328125, 'postprocess': 0.038271427154541016, 'total': 0.09995269775390625}"
14,22,25,9,16,13,0.36,0.4090909090909091,"{'preprocess': 0.05643606185913086, 'inference': 0.0058269500732421875, 'postprocess': 0.03852033615112305, 'total': 0.1007833480834961}"
15,22,24,9,15,13,0.375,0.4090909090909091,"{'preprocess': 0.055320024490356445, 'inference': 0.006063699722290039, 'postprocess': 0.038358211517333984, 'total': 0.09974193572998047}"
16,22,22,9,13,13,0.4090909090909091,0.4090909090909091,"{'preprocess': 0.05440521240234375, 'inference': 0.0058820247650146484, 'postprocess': 0.03867626190185547, 'total': 0.09896349906921387}"
17,22,22,9,13,13,0.4090909090909091,0.4090909090909091,"{'preprocess': 0.05392885208129883, 'inference': 0.005993366241455078, 'postprocess': 0.04005241394042969, 'total': 0.0999746322631836}"
18,22,17,9,8,13,0.5294117647058824,0.4090909090909091,"{'preprocess': 0.05588507652282715, 'inference': 0.00598454475402832, 'postprocess': 0.04013490676879883, 'total': 0.1020045280456543}"
19,22,19,9,10,13,0.47368421052631576,0.4090909090909091,"{'preprocess': 0.05400681495666504, 'inference': 0.006098508834838867, 'postprocess': 0.04003620147705078, 'total': 0.10014152526855469}"
20,21,22,9,13,12,0.4090909090909091,0.42857142857142855,"{'preprocess': 0.05577397346496582, 'inference': 0.0059397220611572266, 'postprocess': 0.04043245315551758, 'total': 0.10214614868164062}"
21,21,17,9,8,12,0.5294117647058824,0.42857142857142855,"{'preprocess': 0.06215620040893555, 'inference': 0.0059626102447509766, 'postprocess': 0.04095172882080078, 'total': 0.1090705394744873}"
22,21,21,9,12,12,0.42857142857142855,0.42857142857142855,"{'preprocess': 0.05839967727661133, 'inference': 0.0065844058990478516, 'postprocess': 0.04040837287902832, 'total': 0.1053924560546875}"
23,22,20,8,12,14,0.4,0.36363636363636365,"{'preprocess': 0.05725908279418945, 'inference': 0.005864143371582031, 'postprocess': 0.04103994369506836, 'total': 0.10416316986083984}"
24,19,19,8,11,11,0.42105263157894735,0.42105263157894735,"{'preprocess': 0.05657458305358887, 'inference': 0.0060825347900390625, 'postprocess': 0.03847670555114746, 'total': 0.10113382339477539}"
25,19,17,8,9,11,0.47058823529411764,0.42105263157894735,"{'preprocess': 0.05692577362060547, 'inference': 0.006107807159423828, 'postprocess': 0.03836846351623535, 'total': 0.10140204429626465}"
26,18,15,7,8,11,0.4666666666666667,0.3888888888888889,"{'preprocess': 0.05734872817993164, 'inference': 0.006045341491699219, 'postprocess': 0.038587331771850586, 'total': 0.10198140144348145}"
27,20,15,7,8,13,0.4666666666666667,0.35,"{'preprocess': 0.05791497230529785, 'inference': 0.0061261653900146484, 'postprocess': 0.038407325744628906, 'total': 0.1024484634399414}"
28,20,13,8,5,12,0.6153846153846154,0.4,"{'preprocess': 0.05695176124572754, 'inference': 0.0059282779693603516, 'postprocess': 0.038581132888793945, 'total': 0.10146117210388184}"
29,19,15,8,7,11,0.5333333333333333,0.42105263157894735,"{'preprocess': 0.055527687072753906, 'inference': 0.006132364273071289, 'postprocess': 0.03839516639709473, 'total': 0.10005521774291992}"
30,19,16,7,9,12,0.4375,0.3684210526315789,"{'preprocess': 0.05766606330871582, 'inference': 0.006164073944091797, 'postprocess': 0.03861808776855469, 'total': 0.1024482250213623}"
31,19,15,7,8,12,0.4666666666666667,0.3684210526315789,"{'preprocess': 0.05698394775390625, 'inference': 0.006162405014038086, 'postprocess': 0.03845858573913574, 'total': 0.10160493850708008}"
32,19,19,7,12,12,0.3684210526315789,0.3684210526315789,"{'preprocess': 0.05819559097290039, 'inference': 0.005988359451293945, 'postprocess': 0.040868282318115234, 'total': 0.10505223274230957}"
33,18,17,7,10,11,0.4117647058823529,0.3888888888888889,"{'preprocess': 0.056972503662109375, 'inference': 0.006060361862182617, 'postprocess': 0.04086494445800781, 'total': 0.1038978099822998}"
34,18,18,7,11,11,0.3888888888888889,0.3888888888888889,"{'preprocess': 0.058511972427368164, 'inference': 0.006030559539794922, 'postprocess': 0.040884971618652344, 'total': 0.10542750358581543}"
35,17,16,7,9,10,0.4375,0.4117647058823529,"{'preprocess': 0.05708456039428711, 'inference': 0.006147861480712891, 'postprocess': 0.040776729583740234, 'total': 0.10400915145874023}"
36,17,17,7,10,10,0.4117647058823529,0.4117647058823529,"{'preprocess': 0.05708813667297363, 'inference': 0.0059490203857421875, 'postprocess': 0.0409398078918457, 'total': 0.10397696495056152}"
37,17,18,6,12,11,0.3333333333333333,0.35294117647058826,"{'preprocess': 0.057970285415649414, 'inference': 0.005942583084106445, 'postprocess': 0.038803815841674805, 'total': 0.10271668434143066}"
38,17,17,7,10,10,0.4117647058823529,0.4117647058823529,"{'preprocess': 0.05725431442260742, 'inference': 0.0060045719146728516, 'postprocess': 0.03859710693359375, 'total': 0.10185599327087402}"
39,17,18,7,11,10,0.3888888888888889,0.4117647058823529,"{'preprocess': 0.0580754280090332, 'inference': 0.005818843841552734, 'postprocess': 0.03871273994445801, 'total': 0.10260701179504395}"
40,17,17,7,10,10,0.4117647058823529,0.4117647058823529,"{'preprocess': 0.05786705017089844, 'inference': 0.00584864616394043, 'postprocess': 0.03858757019042969, 'total': 0.10230326652526855}"
41,17,14,7,7,10,0.5,0.4117647058823529,"{'preprocess': 0.056612491607666016, 'inference': 0.0059261322021484375, 'postprocess': 0.03854203224182129, 'total': 0.10108065605163574}"
42,17,15,7,8,10,0.4666666666666667,0.4117647058823529,"{'preprocess': 0.05720090866088867, 'inference': 0.005903959274291992, 'postprocess': 0.03897404670715332, 'total': 0.10207891464233398}"
43,17,15,7,8,10,0.4666666666666667,0.4117647058823529,"{'preprocess': 0.05787825584411621, 'inference': 0.006051778793334961, 'postprocess': 0.0384521484375, 'total': 0.10238218307495117}"
44,17,17,7,10,10,0.4117647058823529,0.4117647058823529,"{'preprocess': 0.05716681480407715, 'inference': 0.005821704864501953, 'postprocess': 0.03871417045593262, 'total': 0.10170269012451172}"
45,17,20,7,13,10,0.35,0.4117647058823529,"{'preprocess': 0.05787539482116699, 'inference': 0.006192445755004883, 'postprocess': 0.038298606872558594, 'total': 0.10236644744873047}"
46,17,18,8,10,9,0.4444444444444444,0.47058823529411764,"{'preprocess': 0.057329416275024414, 'inference': 0.006083011627197266, 'postprocess': 0.03867745399475098, 'total': 0.10208988189697266}"
47,17,25,8,17,9,0.32,0.47058823529411764,"{'preprocess': 0.05795741081237793, 'inference': 0.005764961242675781, 'postprocess': 0.03873586654663086, 'total': 0.10245823860168457}"
48,17,21,7,14,10,0.3333333333333333,0.4117647058823529,"{'preprocess': 0.056891679763793945, 'inference': 0.00576329231262207, 'postprocess': 0.038971662521362305, 'total': 0.10162663459777832}"
49,17,16,7,9,10,0.4375,0.4117647058823529,"{'preprocess': 0.058866262435913086, 'inference': 0.006661891937255859, 'postprocess': 0.03812003135681152, 'total': 0.10364818572998047}"
50,17,14,7,7,10,0.5,0.4117647058823529,"{'preprocess': 0.05895638465881348, 'inference': 0.005943775177001953, 'postprocess': 0.038614511489868164, 'total': 0.1035146713256836}"
51,17,22,7,15,10,0.3181818181818182,0.4117647058823529,"{'preprocess': 0.05722355842590332, 'inference': 0.006070375442504883, 'postprocess': 0.03889274597167969, 'total': 0.10218667984008789}"
52,17,21,7,14,10,0.3333333333333333,0.4117647058823529,"{'preprocess': 0.05758953094482422, 'inference': 0.00590825080871582, 'postprocess': 0.040334463119506836, 'total': 0.10383224487304688}"
53,17,22,8,14,9,0.36363636363636365,0.47058823529411764,"{'preprocess': 0.0577237606048584, 'inference': 0.005803346633911133, 'postprocess': 0.04052877426147461, 'total': 0.10405588150024414}"
54,17,20,8,12,9,0.4,0.47058823529411764,"{'preprocess': 0.05805540084838867, 'inference': 0.006090402603149414, 'postprocess': 0.03866982460021973, 'total': 0.10281562805175781}"
55,17,23,8,15,9,0.34782608695652173,0.47058823529411764,"{'preprocess': 0.05682778358459473, 'inference': 0.005951881408691406, 'postprocess': 0.0385892391204834, 'total': 0.10136890411376953}"
56,17,20,8,12,9,0.4,0.47058823529411764,"{'preprocess': 0.057416439056396484, 'inference': 0.005932807922363281, 'postprocess': 0.03868460655212402, 'total': 0.10203385353088379}"
57,17,19,8,11,9,0.42105263157894735,0.47058823529411764,"{'preprocess': 0.06626200675964355, 'inference': 0.00598454475402832, 'postprocess': 0.03866839408874512, 'total': 0.11091494560241699}"
58,16,17,7,10,9,0.4117647058823529,0.4375,"{'preprocess': 0.05791831016540527, 'inference': 0.006043195724487305, 'postprocess': 0.040142059326171875, 'total': 0.10410356521606445}"
59,16,18,7,11,9,0.3888888888888889,0.4375,"{'preprocess': 0.05809783935546875, 'inference': 0.005796670913696289, 'postprocess': 0.04029369354248047, 'total': 0.10418820381164551}"
60,16,18,7,11,9,0.3888888888888889,0.4375,"{'preprocess': 0.056955814361572266, 'inference': 0.005805253982543945, 'postprocess': 0.03873014450073242, 'total': 0.10149121284484863}"
61,16,15,7,8,9,0.4666666666666667,0.4375,"{'preprocess': 0.056986331939697266, 'inference': 0.006155967712402344, 'postprocess': 0.03881669044494629, 'total': 0.1019589900970459}"
62,16,19,7,12,9,0.3684210526315789,0.4375,"{'preprocess': 0.05655527114868164, 'inference': 0.0061435699462890625, 'postprocess': 0.03844761848449707, 'total': 0.10114645957946777}"
63,16,16,7,9,9,0.4375,0.4375,"{'preprocess': 0.05780839920043945, 'inference': 0.005811929702758789, 'postprocess': 0.0389704704284668, 'total': 0.10259079933166504}"
64,16,20,8,12,8,0.4,0.5,"{'preprocess': 0.056694984436035156, 'inference': 0.0060350894927978516, 'postprocess': 0.03851056098937988, 'total': 0.10124063491821289}"
65,16,24,8,16,8,0.3333333333333333,0.5,"{'preprocess': 0.056685686111450195, 'inference': 0.006155729293823242, 'postprocess': 0.03877663612365723, 'total': 0.10161805152893066}"
66,17,23,8,15,9,0.34782608695652173,0.47058823529411764,"{'preprocess': 0.057949066162109375, 'inference': 0.005798816680908203, 'postprocess': 0.0387730598449707, 'total': 0.10252094268798828}"
67,17,18,7,11,10,0.3888888888888889,0.4117647058823529,"{'preprocess': 0.05710554122924805, 'inference': 0.005953788757324219, 'postprocess': 0.03871560096740723, 'total': 0.10177493095397949}"
68,17,19,7,12,10,0.3684210526315789,0.4117647058823529,"{'preprocess': 0.05823683738708496, 'inference': 0.006124734878540039, 'postprocess': 0.03885340690612793, 'total': 0.10321497917175293}"
69,17,20,7,13,10,0.35,0.4117647058823529,"{'preprocess': 0.05703306198120117, 'inference': 0.006089210510253906, 'postprocess': 0.038407087326049805, 'total': 0.10152935981750488}"
70,17,17,6,11,11,0.35294117647058826,0.35294117647058826,"{'preprocess': 0.057205915451049805, 'inference': 0.006097555160522461, 'postprocess': 0.03840923309326172, 'total': 0.10171270370483398}"
71,17,17,7,10,10,0.4117647058823529,0.4117647058823529,"{'preprocess': 0.05670332908630371, 'inference': 0.005879878997802734, 'postprocess': 0.039124250411987305, 'total': 0.10170745849609375}"
72,17,16,7,9,10,0.4375,0.4117647058823529,"{'preprocess': 0.05794334411621094, 'inference': 0.0060193538665771484, 'postprocess': 0.038665056228637695, 'total': 0.10262775421142578}"
73,17,16,7,9,10,0.4375,0.4117647058823529,"{'preprocess': 0.05753445625305176, 'inference': 0.005892515182495117, 'postprocess': 0.03884720802307129, 'total': 0.10227417945861816}"
74,17,18,7,11,10,0.3888888888888889,0.4117647058823529,"{'preprocess': 0.058022260665893555, 'inference': 0.0060770511627197266, 'postprocess': 0.03855419158935547, 'total': 0.10265350341796875}"
75,17,16,7,9,10,0.4375,0.4117647058823529,"{'preprocess': 0.05780482292175293, 'inference': 0.005954742431640625, 'postprocess': 0.03887128829956055, 'total': 0.1026308536529541}"
76,17,17,7,10,10,0.4117647058823529,0.4117647058823529,"{'preprocess': 0.05818009376525879, 'inference': 0.00606536865234375, 'postprocess': 0.0385129451751709, 'total': 0.10275840759277344}"
77,17,13,7,6,10,0.5384615384615384,0.4117647058823529,"{'preprocess': 0.058771610260009766, 'inference': 0.006180286407470703, 'postprocess': 0.038435935974121094, 'total': 0.10338783264160156}"
78,16,18,6,12,10,0.3333333333333333,0.375,"{'preprocess': 0.05688118934631348, 'inference': 0.0061495304107666016, 'postprocess': 0.038770437240600586, 'total': 0.10180115699768066}"
79,16,20,6,14,10,0.3,0.375,"{'preprocess': 0.05752110481262207, 'inference': 0.0059757232666015625, 'postprocess': 0.03854680061340332, 'total': 0.10204362869262695}"
80,16,25,6,19,10,0.24,0.375,"{'preprocess': 0.057302236557006836, 'inference': 0.0060346126556396484, 'postprocess': 0.03853201866149902, 'total': 0.10186886787414551}"
81,17,22,6,16,11,0.2727272727272727,0.35294117647058826,"{'preprocess': 0.05757927894592285, 'inference': 0.006190776824951172, 'postprocess': 0.0387263298034668, 'total': 0.10249638557434082}"
82,17,20,7,13,10,0.35,0.4117647058823529,"{'preprocess': 0.056916236877441406, 'inference': 0.0058135986328125, 'postprocess': 0.038799285888671875, 'total': 0.10152912139892578}"
83,17,18,7,11,10,0.3888888888888889,0.4117647058823529,"{'preprocess': 0.056754112243652344, 'inference': 0.005916118621826172, 'postprocess': 0.038619041442871094, 'total': 0.10128927230834961}"
84,17,22,7,15,10,0.3181818181818182,0.4117647058823529,"{'preprocess': 0.056960105895996094, 'inference': 0.006126880645751953, 'postprocess': 0.03848576545715332, 'total': 0.10157275199890137}"
85,17,14,7,7,10,0.5,0.4117647058823529,"{'preprocess': 0.05740189552307129, 'inference': 0.006117343902587891, 'postprocess': 0.03857088088989258, 'total': 0.10209012031555176}"
86,17,21,7,14,10,0.3333333333333333,0.4117647058823529,"{'preprocess': 0.05787920951843262, 'inference': 0.005930662155151367, 'postprocess': 0.038710594177246094, 'total': 0.10252046585083008}"
87,17,22,7,15,10,0.3181818181818182,0.4117647058823529,"{'preprocess': 0.05781078338623047, 'inference': 0.006177663803100586, 'postprocess': 0.03832674026489258, 'total': 0.10231518745422363}"
88,17,16,7,9,10,0.4375,0.4117647058823529,"{'preprocess': 0.05750417709350586, 'inference': 0.005968570709228516, 'postprocess': 0.0389101505279541, 'total': 0.10238289833068848}"
89,17,21,8,13,9,0.38095238095238093,0.47058823529411764,"{'preprocess': 0.057038068771362305, 'inference': 0.005890369415283203, 'postprocess': 0.03868699073791504, 'total': 0.10161542892456055}"
90,18,21,6,15,12,0.2857142857142857,0.3333333333333333,"{'preprocess': 0.057623863220214844, 'inference': 0.006143808364868164, 'postprocess': 0.038419246673583984, 'total': 0.10218691825866699}"
91,19,21,7,14,12,0.3333333333333333,0.3684210526315789,"{'preprocess': 0.056647539138793945, 'inference': 0.0058956146240234375, 'postprocess': 0.038693904876708984, 'total': 0.10123705863952637}"
92,19,22,10,12,9,0.45454545454545453,0.5263157894736842,"{'preprocess': 0.0581817626953125, 'inference': 0.0060160160064697266, 'postprocess': 0.03872370719909668, 'total': 0.1029214859008789}"
93,19,17,9,8,10,0.5294117647058824,0.47368421052631576,"{'preprocess': 0.05761265754699707, 'inference': 0.00582575798034668, 'postprocess': 0.03875303268432617, 'total': 0.10219144821166992}"
94,19,19,10,9,9,0.5263157894736842,0.5263157894736842,"{'preprocess': 0.057450294494628906, 'inference': 0.0058133602142333984, 'postprocess': 0.038810014724731445, 'total': 0.10207366943359375}"
95,19,20,10,10,9,0.5,0.5263157894736842,"{'preprocess': 0.0574648380279541, 'inference': 0.0061435699462890625, 'postprocess': 0.03847217559814453, 'total': 0.1020805835723877}"
96,19,13,7,6,12,0.5384615384615384,0.3684210526315789,"{'preprocess': 0.05652117729187012, 'inference': 0.005904436111450195, 'postprocess': 0.03871488571166992, 'total': 0.10114049911499023}"
97,19,19,8,11,11,0.42105263157894735,0.42105263157894735,"{'preprocess': 0.05673575401306152, 'inference': 0.00593113899230957, 'postprocess': 0.03910517692565918, 'total': 0.10177206993103027}"
98,19,22,8,14,11,0.36363636363636365,0.42105263157894735,"{'preprocess': 0.05819439888000488, 'inference': 0.006072282791137695, 'postprocess': 0.038518428802490234, 'total': 0.10278511047363281}"
99,19,20,5,15,14,0.25,0.2631578947368421,"{'preprocess': 0.05774188041687012, 'inference': 0.0060193538665771484, 'postprocess': 0.038568735122680664, 'total': 0.10232996940612793}"
100,18,15,7,8,11,0.4666666666666667,0.3888888888888889,"{'preprocess': 0.05796217918395996, 'inference': 0.006035804748535156, 'postprocess': 0.039174795150756836, 'total': 0.10317277908325195}"
